##############
##          M#
## ######### #
## #       # #
## # ##### # #
##   #     # #
#### # ##### #
#I   #       #
##############