#########################################
##           #       #        # #########
## ######### ####### # ###### # #########
## #       # #       #     ##    ###  M##
## # ##### # # ####### ### ## # #### ####
##   #     # #      #  #### #           #
#### # ##### ###### # ###   # ######### #
#    #                  ##     #        #
#### # ###### ####### # ##  #  #  ##### #
###    ##     #   #   #     #     ###   #
##  ##  ### # # # # # ############### ###
#I ####     #   #   #                   #
#########################################