##########
#      I #
#   ######
#        #
#   ##   #
#        #
######   #
# M      #
##########