############
#M      # ##
#  #  #    #
#  #     I #
############