########################################
#                                    I #
#   ##############   ###################
#                                      #
#   ################################   #
#                                      #
####################################   #
# M                                    #
########################################
